EIT_Mux	KEYWORD1
EIT_Settings	KEYWORD1
EIT_DataCollector	KEYWORD1
EIT_Circuit	KEYWORD1
turnMuxOnOff	KEYWORD2
switchMux	KEYWORD2
recordSettings	KEYWORD2
waitForSignal	KEYWORD2
setReferenceVoltage	KEYWORD2
collectVoltageData	KEYWORD2
printVoltageData	KEYWORD2
collectResistanceData	KEYWORD2
printResistanceData	KEYWORD2
recordStartTime	KEYWORD2
printStartTime	KEYWORD2
getStartTime	KEYWORD2
switchCurrentChannel	KEYWORD2
getData	KEYWORD2
getSettings	KEYWORD2
sendData	KEYWORD2
turnIndicatorOnOff	KEYWORD2